################
#--------------#
#--##------##--#
#----------##e-#
#------#-------#
#------#-------#
#------#----#--#
#--e#--#-------R
#-###--#-e----- 
#------#########
#--------------#
#-----------#--#
#-######----#e-#
#-######----##-#
#-e------------#
#######D #######