##############
#p-----------#
#-########-#-#
#-#------#-#-#
#-#-#----#-#-#
#-#-#-#----#-#
#-#-#-#--#-#-#
#-#-#-#----#-#
#-#-#-#-e#-#-#
#-#-######-#-#
#----------#-#
#-##########-#
#------------#
##############