#########
#-------#
#-------#
#-------#
#---p---#
#-------#
#-----+-#
#-------#
#########
