#########
#-------#
#-------#
#-------#
#---p---#
#-------#
#-------#
#-------#
####+####
