############
#----------#
#----------#
#----------#
#----------#
L----------R
 ---------- 
#----------#
#----------#
#----------#
#----------#
############