############
#----------#
#----------#
#----e-----#
#----------#
R----------R
 ---------- 
#----------#
#----------#
#----------#
#--------e-#
############