########
#------#
#------#
L----e-#
 ------#
#------#
#------#
########