########
#-e----#
#------#
L------R
L------R
#------#
#------#
########