########
#-e----#
#------#
L------R
 ------ 
#------#
#------#
########