############
#----------#
#----------#
#----------#
#----------#
#----------R
#----------R
#----------#
#----------#
#----------#
#----------#
############