########
#------#
#------#
L----e-#
L------#
#------#
#------#
########