#######U #######
#--------------#
#------------e-#
#--####--------#
#--####--------#
#-e####-----##-#
#######-----##-#
L-----#--------#
 -----#-------e#
#-----#--------#
#------e--##---#
#---------##e--#
#---------##---#
#--##-----##---#
#--e-----------#
################