#######U #######
#--------------#
#--e-----------#
#--##----------#
#--#-----------#
#--###----####-#
#---------#-e#-#
#---------#--#-R
#--####---#--#- 
#-e####-----e#-#
#--####---####-#
#--------------#
#--------------#
#----e--###----#
#-------###--e-#
################